                            
 ............  ............ 
 .    .     .  .     .    . 
 .    .     .  .     .    . 
 .    .     .  .     .    . 
 .......................... 
 .    .  .        .  .    . 
 .    .  .        .  .    . 
 ......  ....  ....  ...... 
      .     .  .     .      
      .     .  .     . 
      .  ..........  . 
      .  .        .  . 
      .  .        .  . 
      ....        .... 
      .  .        .  . 
      .  .        .  . 
      .  ..........  . 
      .  .        .  . 
      .  .        .  .      
 ............  ............ 
 .    .     .  .     .    . 
 .    .     .  .     .    . 
 ...  ........*.......  ... 
   .  .  .        .  .  .   
   .  .  .        .  .  .   
 ......  ....  ....  ...... 
 .          .  .          . 
 .          .  .          . 
 .......................... 
