============================
=            ==            =
= ==== ===== == ===== ==== =
= =  = =   = == =   = =  = =
= ==== ===== == ===== ==== =
=                          =
= ==== == ======== == ==== =
= ==== == ======== == ==== =
=      ==    ==    ==      =
====== ===== == ===== ======
     = ===== == ===== =
     = ==          == =   
     = == ======== == =
     = == =      = == =
     =    =      =    =
     = == =      = == =
     = == ======== == =
     = ==          == =
     = == ======== == =
====== == ======== == ======
=            ==            =
= ==== ===== == ===== ==== =
= ==== ===== == ===== ==== =
=   ==                ==   =
=== == == ======== == == ===
=== == == ======== == == ===
=      ==    ==    ==      =
= ========== == ========== =
= ========== == ========== =
=                          =
============================